.,-_ '`!?:;­´"()[]<>{}/\*«»‘’‚‛“”„‟…=
aÀÂÃÄÅÆĀĂĄǠǢǍǞǺǼȀȂȦàâãäåæāăąǡǣǎǟǻǽȁȃȧ=A
Áá=Á
bƀƁƂƃƄƅ=B
cÇĆĈĊČƆƇçćĉċčƈ=C
dĎĐƉƊƋďđƌƍ=D
eÈÊËĒĔĖĘĚƎƏƐȄȆȨèêëēĕėęěȅȇȩ=E
Éé=É
fƑƒ=F
gĜĞĠĢƓǤǦǴĝğġģǥǧǵ=G
hĤĦǶȞĥħƕǷȟ=H
iÌÍÎÏĨĪĬĮİĲƖȈȊìíîïĩīĭįıĳƗȉȋ=I
jĴĵ=J
kĶƘǨķĸƙǩ=K
lĹĻĽĿŁĺļľŀłƛƚ=L
mƜµ=M
nÑŃŅŇŊƝñńņňŉŋƞ=N
oÒÓÔÕŌŎŒƟƠƢǑǪǬǾȌȎȪȬȮȰòóôõōŏœơƣǒǫǭǿȍȏȫȭȯȱ=O
ÖØŐöøő=Ö
pƤƥ=P
q=Q
rŔŖŘƦȐȒŕŗřȑȓ=R
sßŚŜŞŠƧƩȘśŝşšƨƪș=S
tŢŤŦƬƮȚţťŧƫƭț=T
uÙÚÛŨŪŬŮŲƯƱǓǕǗǙǛȔȖùúûũūŭůųưƲǔǖǘǚǜȕȗ=U
ÜüŰű=Ü
v=V
wŴŵ=W
x=X
yÝŶŸƳȲýÿŷƴȳ=Y
zŹŻŽƵƷƹƻǮȤźżžƶƸƺǯȥ=Z
